logtostderr	False
alsologtostderr	False
log_dir	
v	0
verbosity	0
stderrthreshold	fatal
showprefixforinfo	True
run_with_pdb	False
pdb_post_mortem	False
run_with_profiling	False
profile_file	None
use_cprofile_for_profiling	True
only_check_args	False
op_conversion_fallback_to_while_loop	False
test_random_seed	301
test_srcdir	
test_tmpdir	/tmp/absl_testing
test_randomize_ordering_seed	None
xml_output_file	
bert_config_file	./topic_bert/topic_bert/cased_L-12_H-768_A-12/bert_config.json
bert_vocab_file	./topic_bert/topic_bert/cased_L-12_H-768_A-12/vocab.txt
data_dir	./topic_bert/dataset/reuters8/bert_and_gsm_doc_classification
output_dir	./topic_bert/outputs_nvdm_only/reuters8/reuters8_sigmoid_n_topics_100
max_seq_length	512
init_checkpoint	./topic_bert/topic_bert/cased_L-12_H-768_A-12/bert_model.ckpt
pretrain_nvdm_path	
train_batch_size	4
eval_batch_size	4
num_cores	8
learning_rate	2e-05
warmup_proportion	0.1
patience	5
save_after_epoch	1.0
num_train_epochs	100.0
concat	True
projection	True
gating	False
hidden_size_TM	256
n_topic	100
n_sample	10
proj_size	100
alpha	0.1
gsm_lr_factor	1.0
pretrain_bert	False
load_wiki_during_pretrain	False
pretrain_nvdm	True
combined_train	True
nvdm_alternate_epoch	10
nvdm_train_epoch	1000
nvdm_validation_ppl_freq	1
nvdm_validation_ir_freq	1000000
nvdm_learning_rate	0.001
nvdm_batch_size	64
nvdm_patience	10
nvdm_multi_label	False
nvdm_num_class	2
use_gpu	True
topic_model	nvdm
supervised_TM	False
?	False
help	False
helpshort	False
helpfull	False
helpxml	False
